111111111111111111111111111111
100000000000000000000000000001
100000000C00000100000000000001
110000000000000000P00000000001
100000000000000000000000000001
100000000000000000000000000001
100000000000C10000000000000001
1000C10000C00000C0000000000001
100000000000000000000000000001
1000000000000001000C0000000001
1000000010000000E000000000C001
111111111111111111111111111111
