1111111111111111111111
10000C00000E0000000P01
1000100000000000000001
1000001000000100000001
10000000C00010000C0001
10C0000000000000000001
1001000000000100100001
1111111111111111111111
